{
  "Map": [
    [1, 1, 1, 1, 1, 1, 1, 1, 1, 1, 1, 1, 1, 1, 1],
    [1, 0, 0, 0, 1, 1, 1, 0, 0, 0, 0, 0, 0, 3, 1],
    [1, 0, 0, 0, 1, 1, 1, 0, 0, 1, 1, 0, 0, 0, 1],
    [1, 3, 0, 1, 1, 1, 0, 0, 0, 1, 1, 0, 0, 0, 1],
    [1, 1, 0, 1, 1, 1, 0, 1, 1, 1, 1, 1, 1, 1, 1],
    [1, 0, 0, 0, 0, 0, 0, 1],
    [1, 1, 1, 1, 1, 1, 1, 1]
  ],
  "Players": [
    {
	  "Color": "#FAF",
	  "MovementKeys": 0,
      "Location": {
        "X": 1,
        "Y": 1
      }
    },
    {
	  "Color": "#FFDFD991",
	  "MovementKeys": 1,
      "Location": {
        "X": 1,
        "Y": 2
      }
    }
  ]
}